5,1~6,1:10
#########
#    @@ #
#       #
#  ######
#       #
#   BB  #
#      I#
#########